1111111111111111111111111
1010110000000000000040001
1000130011111111111111101
1010101010000020000010001
1010001111111111111011111
1010101000010030000000101
1011101011010111111110001
1020100001110110000040101
1010111101000011111110101
1010010001011201000011101
1011001110010011101001001
1011010000100100110101011
1100010110101110100001001
1111111111111111111111111